00000101210000
01111611110000
01111111111100
01611111611100
11111511116165
51161114111110
00111111611110
00111111111160
00006116116110
00001310100000