00000510000
00001111100
00011116110
00116111100
01611111110
31111511610
01111111110
06114111110
01116116112
01111111110
00611611100
01111111000
00161160000
00001500000