00000300000000
00001116110100
00016111116110
00111111111160
01161114611111
51111511111115
11111111116160
01611111611100
01111611111000
00101111110000
00000000200000